課題１ー０
ネットワーク→ネットワークは、パソコン、スマホなどの通信端末や各種サーバーの間を有線や無線でつなぎ、情報の伝送を行うための通信設備のことであり、通信回線と通信機器から構成される。

・有線LANモデムとパソコンをLANケーブルを使って接続する方法が有線LAN

・無線LAN →LANケーブルを使わず電波で無線接続する方法が無線LAN

WAN
・インターネット→インターネットは、世界中のコンピュータなどの情報機器を接続するネットワーク

* ノード→コンピューター一つ一つに繋がっている機器（PC、スマホ、プリンター、テレビ）
* リンク→ノードとノードを繋げているもの(ケーブルなど）
* トポロジ→ネットワーク内でネットワーク機器や端末がどのような位置関係で接続されているかを表すレイアウト
    * バス型トポロジ→1本のケーブル（同軸ケーブル）に複数のノードを接続しているトポロジーのこと
    * スター型トポロジ→1つの集線装置（ハブやスイッチ）に複数のノードを接続しているトポロジーのこと。
    * メッシュ型トポロジ→多くののノードが相互接続する形態で、WAN、インターネットで使われる。

* 帯域→特定の時間内にネットワーク接続を介して送信できるデータの最大容量を指します。帯域幅が大きくなるほど、一度に送受信できるデータが多くなります。
    * bps→「bit per second（ビット・パー・セカンド）」の頭文字をとったもので、読み方は「ビーピーエス」です。 1秒間にどれくらいのbitを送ることができるかを表しており、数値が大きいほど回線が速いことを意味します。
* 輻輳→様々なものが1ヶ所に集中して混雑している状態を指します。そして「ネットワーク輻輳」は通信回線にアクセスが集中している状態を指します。
* コリジョン→衝突や激突といった意味の英単語です。 イータネットや無線LANの同一伝送路を共有する複数の端末が、同時に信号を発信した際にデータが衝突することを表します。
* ドメイン→インターネット上の住所のことで、Webサイトがどこにあるかを判別する情報として利用します。
* ポート→ネットワーク接続を開始・終了するための仮想的なポイントです。

 モデル
* プロトコル→コンピュータでデータをやりとりするために定められた手順や規約、信号の電気的規則、通信における送受信の手順などを定めた規格を意味します。
* OSI参照モデル→OSI reference model）は、コンピューターネットワークで利用されている多数のプロトコルについて、それぞれの役割を分類し、明確化するためのモデル
ヘッダ→一般的にデータや文書の先頭に付け加えられた情報のことを指します。
    * カプセル化→特定のデータ構造とアルゴリズムなどをまとめたソフトウェア複合体の内側の詳細を外側から隠蔽すること
    * 非カプセル化→データを受け取った側は、必要なデータを取り出すために各階層毎にヘッダを取り外していきます。
    * PDU→専門技術者の継続的開発を計測する方法の一つ
        * MTU →ネットワークで一回に送信できる最大のデータサイズのこ
        * フレーム→斜面崩壊や地すべりを防止するためのグラウンドアンカーの受圧構造物であり
        * パケット→通信するときには、大きいデータの塊をそのまま送るのは大変だから、一旦細かく分けて送って、届いた先で合体させて元に戻すんだけど、その際の「細かく分けたデータ」のこ
        * セグメント→セグメントとは、集団やまとまりを区切った区分のこと。
* TCP/IPモデル→CP/IP（Transmission Control Protocol/Internet Protocol）は、現在のインターネット通信および
　イントラネット通信において最も利用されている通信プロトコルです。

■ 物理層
* ビット→ビットとは、コンピュータ上で扱われる情報量の最小単位のことです。（コンピュータの世界では、1バイト（Byte）= 8ビット（bit）と定義されておる。）
* ツイストペアケーブル→２本の導体を撚り合わせたもので、主に 平衡伝送のための媒体として用いられている。このペアを何対か集めてゴムなどの被覆材で覆って一本のケーブルとしたもの。
    * UTP→「Unshielded Twisted Pair」の略です。「UTPケーブル」とは「シールド処理が施されていない、ペアの撚りケーブル」を指します。一般的なLANケーブルはこのUTPケーブルを意味しており、家庭やオフィスなど多くの環境で使用されています。
    * STP→Shielded Twisted Pair」の略であり、STPケーブルは「シールド処理が施されているペアの撚りケーブル」を意味します。シールド処理を実施することにより、電磁波やノイズへの高い耐性を実現しています。
    * カテゴリー→LANケーブルにも通信規格があり、CATというカテゴリで分けられています。
    * コネクタ→電力や電気信号の流れをつなぐための電子部品です。
* ストレートケーブル→コネクタ同士の同じピン同士を接続しているため、コネクタ部分を見ると同じ色の線が同じ順番で並んでいます。
* クロスケーブル→パソコンとパソコンを機器を使用せず直接接続する場合に使用するケーブルです。
単純に 2 台のパソコンをケーブルで接続しデータ通信する場合にはクロスケーブルを使用します
* 光ファイバケーブル→透過率の高い石英ガラスやプラスチックなどで作られた光の伝送路のことです。1本1本は非常に細い繊維状で、光ファイバーを複数束ねるとより大容量の光（情報）を通す「光ファイバーケーブル」となり、主にインターネット回線に用いられます。
* ハブ→車輪（ホイール）などの中心部のことを指す言葉です。そこから転じて、物事の中心や中核、集約点という意味で使われるようになりました。
    * 半二重通信→送信側、受信側を交互にデータを送出することで、双方向の通信ができます。

■ データリンク層
* イーサネット→主にパソコンなどで信号をやり取りに用いられている規格です。
    * イーサネット
    * ファストイーサネット→元来のイーサネットの速度10Mbpsに対し、公称100Mbpsの速度でトラフィックを伝えるいくつかのイーサネット規格の総称です。
    * ギガビットイーサネット→最大通信速度が1ギガビット毎秒(1Gbps)である仕様のイーサネットの規格で、1GbEとも表記されます。
* イーサネットヘッダ→ネットワーク上を流れるデータの中身の一部で、イーサネットってお約束事で使う情報が書かれている部分のこと
* トレーラ⇨被牽引車、荷台車両、予告編、次回予告などの意味を持つ英単語。映画やビデオゲームなどで、新作の宣伝のために制作された短い映像（予告編）のことをトレーラームービーあるいは単にトレーラーという。
* CSMA/CD→Carrier Sense Multiple Access with Collision Detection）とは、データの衝突（＝コリジョン）を避けるための仕組みと、万が一衝突が発生した場合にデータを再送する仕組みを兼ね備えた通信制御方法です。
* MACアドレス→ネットワーク機器やネットワークアダプターに付いている固有の識別番号。 有線LANのほかに、無線LANやスマートフォンにもMACアドレスが割り当てられている。
* スイッチ→ハブと同じように複数のデバイスを束ねる集線装置としての役割があります。 スイッチはハブが必要のないデバイスにもデータを通信してしまうという非効率な点を改善するために登場したネットワーク機器
    * MACアドレステーブル→ネットワークスイッチなどが内部的に管理している情報で、どのポート（端子）にどのMACアドレスを持つ機器が接続されているかを記録したもの
    * フラッディング→「洪水」を意味する言葉です。 ネットワーク機器の処理能力を超えるデータ量が発生し、ネットワークシステムの動作に支障が出る状態のことをフラッディングと呼びます
    * 全二重通信
* VLAN→「Virtual Local Area Network」の略で、「仮想LAN」「バーチャルLAN」とも呼ばれます。 コンピュータネットワークにおいて、物理的な接続形態とは別に仮想的（バーチャル）なLANセグメント（個々のネットワーク環境のこと）を作る技術のこと
* タグVLAN→VLANタグと呼ばれるIDをイーサネットフレームに付加して、スイッチをまたいで転送されたフレームがどのVLANに属するか識別する機能
・ポートベースVLAN→LANスイッチなどがポートごとに端末を認証する方式である。
        * アクセスポート→1つのネットワークを形成する穴のことです。 主にPCやプリンターなどの端末とスイッチ（ネットワークを作る機器のこと）を接続するために使われる
        * トランクポート→複数のネットワークを形成できる穴のこと
    * DTP→Desktop Publishing（デスクトップ パブリッシング）」の略であり、パソコン上で印刷物のデータを制作することです。
    * デフォルトVLANVLANを設定したネットワークスイッチで、VLANの指定が無いポートやフレームの通信に用いられるVLANのこと。
    * ネイティブVLAN→トランクリンク上でイーサネットフレームを転送するときに例外的にVLANタグを付加しないVLAN
* ブロードキャストストーム→ネットワーク全体に情報を送信するブロードキャストパケットがいっせいにネットワークに送り出されることで、ネットワーク上が嵐（stoem）に遭ったようにいっぱいになって使用不能となることである
* スパニングツリープロトコル→「Spanning Tree Protocol」の略で、Ethernetにおける冗長化技術のプロトコルです。円環状に構成されたネットワークにおいてデータが永続的に流れ続ける状態を防ぎます。
* リンクアグリゲーション→複数の物理回線を1つの論理リンクとして扱う技術です
* EtherChannel→複数の物理リンクを束ねて1つの論理リンクとして扱える技術のことです。 一般的には リンクアグリゲーションと呼ばれる技術のことですが、Ciscoではそれを EtherChannel と呼んでいます。
